xxxxxxxxxxxxxxxx
x 			   x       
x 			   x
x              x
x~~~~~~~~~~~~~~x
x~~~~~~~~~~~~~~x
x              x
x              x
x              x
xxxxxxxxxxxxxxxx